###################
#                 #
################# #
#                 #
#   ####OOO########
#            C   C#
#                M#
###################
