#######
#  C M#
# ### #
#     #
#######
