########
# #    #
# # ## #
#    #M#
########
