########
# #    #
# # ## #
#     M#
########
